111111111111111111111111111111111111111111111111111111
100100C00C00E0000000100100C00C00E0000000100100C00C00E1
10000100100C00C00E0000000100100C00C00E0000000100100C01
10E0000000100100C00C00E0000000100100C00C00E00000001001
1C00C00E0000000100100C00C00E0000000100100C00C00E000001
100100C00C00E0000000100100P00C00E0000000100100C00C00E1
10000100100C00C00E0000000100100C00C00E0000000100100C01
10E0000000100100C00C00E0000000100100C00C00E00000001001
1C00C00E0000000100100C00C00E0000000100100C00C00E000001
100100C00C00E0000000100100C00C00E0000000100100C00C00E1
10000100100C00C00E0000000100100C00C00E0000000100100C01
10E0000000100100C00C00E0000000100100C00C00E00000001001
1C00C00E0000000100100C00C00E0000000100100C00C00E000001
100100C00C00E0000000100100C00C00E0000000100100C00C00E1
10000100100C00C00E0000000100100C00C00E0000000100100C01
10E0000000100100C00C00E0000000100100C00C00E00000001001
1C00C00E0000000100100C00C00E0000000100100C00C00E000001
100100C00C00E0000000100100C00C00E0000000100100C00C00E1
10000100100C00C00E0000000100100C00C00E0000000100100C01
10E0000000100100C00C00E0000000100100C00C00E00000001001
1C00C00E0000000100100C00C00E0000000100100C00C00E000001
100100C00C00E0000000100100C00C00E0000000100100C00C00E1
10000100100C00C00E0000000100100C00C00E0000000100100C01
10E0000000100100C00C00E0000000100100C00C00E00000001001
1C00C00E0000000100100C00C00E0000000100100C00C00E000001
100100C00C00E0000000100100C00C00E0000000100100C00C00E1
10000100100C00C00E0000000100100C00C00E0000000100100C01
10E0000000100100C00C00E0000000100100C00C00E00000001001
1C00C00E0000000100100C00C00E0000000100100C00C00E000001
100100C00C00E0000000100100C00C00E0000000100100C00C00E1
10000100100C00C00E0000000100100C00C00E0000000100100C01
10E0000000100100C00C00E0000000100100C00C00E00000001001
1C00C00E0000000100100C00C00E0000000100100C00C00E000001
100100C00C00E0000000100100C00C00E0000000100100C00C00E1
10000100100C00C00E0000000100100C00C00E0000000100100C01
10E0000000100100C00C00E0000000100100C00C00E00000001001
1C00C00E0000000100100C00C00E0000000100100C00C00E000001
100100C00C00E0000000100100C00C00E0000000100100C00C00E1
10000100100C00C00E0000000100100C00C00E0000000100100C01
10E0000000100100C00C00E0000000100100C00C00E00000001001
1C00C00E0000000100100C00C00E0000000100100C00C00E000001
111111111111111111111111111111111111111111111111111111
