11111111111111111
10C00000000000001
10000C00C00000001
100000000P0000001
10C0E00000C000001
11111111111111111