
11111111111111111
10C00001000000001
10000C01C00001001
100000100P0000001
10C0E00000C000001
11111111111111111