111111111111111111111111111111111111111111111111111
100000000000000000000000000000000000000000000000001
100000000000000000000000000000000000000000000000001
100000000E00000000000000000000000000000000000000001
1000E0000000000000000000000000000000000000000000001
111111011111111100000000000A00000000000000000000001
111111011111111100000000000000000000000000000000001
100000000000000000000000000000000000000000000000001
100000000000000000000000000000000000000000000000001
100000000000000000000000000000000000000000000000001
1000E0000000000000000000000000000000000000000000001
111111111111111100000000000000000000000000000000001
111111111111111100000000000000000000000000000000001
100000000000000000000000000000000000000000000000001
100000000000000000000000000000000000000A00000000001
100000000E00000000000000000000000000000000000000001
1000E0000000000000000000000000000000000000000000001
111111011111111100000000000000000000000000000000001
111111011111111100000000000000000000000000000000001
100000000000000000000000000000000000000000000000001
100000000000000000000000000000000000000000000000001
100000000P00000000000000000000000000000000000000001
1000E0000000000000000000000000000000000000000000001
111111111111111100000000000000000000000000000000001
111111111111111111111111111111111111111111111111111
