11111111111111111
10000000000000001
10000000000000001
100000000E0000001
1000E000000000001
11111101111111111
11111101111111111
10000000000000001
10000000000000001
100000000P0000001
1000E000000000001
11111111111111111