1111111111111111111111111111111111111111111111111111
1111111111111111111111111111111111111111111111111111
1100000000000000000000000000000000000000000000000011
1100000000000000000000000000000000000000000000000011
110000000E000000000000000000000000000000000000000011
1100E00000000000000000000A00000000000000000000000011
1111110111111111000000000000000000000000000000000011
1111110111111111000000000000000000000000000000000011
1100000000000000000000000000000000000000000000000011
1100000000000000000000000000000000000000000000000011
1100000000000000000000000000000000000000000000000011
1100E00000000000000000000000000000000000000000000011
1111111111111111000000000000000000000000000000000011
111111111111111100000000000000000A000000000000000011
1100000000000000000000000000000000000000000000000011
1100000000000000000000000000000000000000000000000011
110000000E000000000000000000000000000000000000000011
1100E000000000000000000000000C0000000000000000000011
1111110111111111000000000000000000000000000000000011
1111110111111111000000000000000000000000000000000011
1100000000000000000000000000000000000000000000000011
1100000000000000000000000000000000000000000000000011
110000000P000000000000000000000000000000000000000011
1100E00000000000000000000000000000000000000000000011
1111111111111111000000000000000000000000000000000011
1111111111111111111111111111111111111111111111111111
1111111111111111111111111111111111111111111111111111