11111111111111111
10000010000000001
10000000000000001
100000000P0000011
1001E000000000001
11111111111111111