11111111111111111
10000010000000001
10000C00000000001
100000000P0000011
1001E0000000P0001
11111111111111111