11111111111111111
10C00001000001001
10000C01C11111001
100000100P1111001
10C0E00001C000001
11111111111111111