111111111111111111
10000C000000000001
111111110000000C01
100000000000100001
10C000000000000001
10000000P111001101
100000111001100011
100E0100000000C001
111111111111111111