1111111111
1000001001
1C00C00E01
1000100101
10C00E0001
10100100C1
100E000001
1001P0C001
1E00000001
1111111111
