1111111111
11111110E1
1C00C10011
1011110111
10C0000111
11111100C1
1111110111
1111P0C111
1111111111
1111111111
