1111111111
10000010E1
1C00C01001
1010100111
10C0000101
10100100C1
1000000001
1001P0C001
1000010001
1111111111
