1111111111
1000001001
1C00C00E01
1010100101
10C00E0101
101E0100C1
1000000001
1001P0C001
1E00010001
1111111111
