1111111111
1000001001
1C00C00E01
10A0100101
10C00E0A01
101E0100C1
1000000001
1001P0C001
1E000A0001
1111111111
