11111111111111111111
11001P0C00C00E000001
100100C00C00E0000001
10100C00C00E00000001
1100C00C00E000000011
100C00C00E0000000101
10C00C00E00000001001
1C00C00E000000010011
100C00E0000000100101
11111111111111111111
