1111111111
1C0C0000E1
1CCC111101
1CPA1000C1
1111111111
